o......x.
.......x.
xxxxx..x.
.........
.....f...
.........
